111111111111111111
100000000000000011
100000000000C00011
1000C0000000000011
100000000000000011
100000000C00000001
100000000000000001
100C00000000000001
100000000000000001
100C0001C1C1000011
100000000000000001
10000000C000000001
1P0C00000000C000E1
111111111111111111
111111111111111111
