111111111111111111
100000000000000011
100000000010C00011
1000C0000100000E11
100000000000000011
100000001C00000001
100000000000000001
100C00001100011111
100000000100000001
100C00011111000011
100000000000100001
10000000C000000001
1P0C00000000C00101
111111111111111111
111111111111111111
