111111111111111111
1000000000000CC001
100000000000000001
100000000000000001
100000000000000001
100000000001000001
100000000011000001
100000000111000001
100000001111000001
100C00011111000001
100000111111000001
100001111111000001
1P00111111110000E1
111111111111111111
111111111111111111
