111111111111111111111111111111111
100000000000000000000000000000001
100000000000000000000000000000001
100000000000000000000000000000001
100000000000000000000000000000001
100000000C00000000000000000000001
100000000000000000000000000000001
100000000000000000000000000000001
100000000000000000000000000000001
100C0001C1C1000000000000000000001
100000000000000000000000011000001
100000000000000110000000011000001
1P00000000000001100000000110000E1
111111111111111111111111111111111
111111111111111111111111111111111
