1111111111111111111111111111111111111111111
1000000000000000000000000000000000000000001
1000000000000000000000000000000000000000001
1000000000000000000000000000000000000000001
1000000000000000000000000000000000000000001
10000000C0000000000000000000000000100000001
100000000000000000000CC00000000001100000001
10000000000000CC000000000000000011100000001
1000000000000000000000000000000111100000001
100C001C1C100000000000000000001111100000001
1000000000000000000001100000011111100000001
1000000000000011000001100000111111100000001
1P000000000000110000011000011111111000000E1
1111111111111111111111111111111111111111111
1111111111111111111111111111111111111111111
