11111111
10000001
10000001
1P000CE1
11111111
