111111111111111111
100000000000000011
100000000010C00011
1000C0000100000011
100000000000000011
100000001C00000001
100000000000000001
100C00001100000001
100000000000000001
100C000111C1000011
100000000000000001
10000000C000000001
1P0C00000000C000E1
111111111111111111
111111111111111111
