111111111111111111
100000000000000001
100000000000000001
100000000000000001
100000000000000001
100000000C00000001
100000000000000001
100000000000000001
100000000000000001
100C0001C1C100001
100000000000000001
100000000000000001
1P00000000000000E1
111111111111111111
111111111111111111
