111111111111111111
100000000000000001
100000000000000001
100000000000000001
100000000100000001
100000001C10000001
100000000100000001
100000000000000001
100000000000000001
100C0001C1C1000011
100000000000000001
100000000000000011
1P00000000000001E1
111111111111111111
111111111111111111
